440444044440000000-
040404040040000000-
040404040040000000-
040404040040000000-
040404040040000000-
040404040040000000-
044404440044440000-
000000000000000000